NO assets/textures/north.xpm
SO assets/textures/south.xpm
WE assets/textures/east.xpm
EA assets/textures/west.xpm
F 194,160,,128
C 217,117,119
111111111111111111111
101000001000000000001
101010101011111110001
100010100010000010001
111110101111101011101
100000101000101000001
101111101011101111111
101000001010100000101
101011111010111110101
101010001010100010101
101110101010001010101
100000000000000000001
100000101DN0000101001
100000000000000000001
111111101011111011101
100000101000100010001
101110101110101110111
101000100000100010101
101011111111111010101
100010000000000010001
101010111011111111101
100000000000000000001
111111111111111111111
