NO assets/textures/north.xpm
SO assets/textures/south.xpm
WE assets/textures/east.xpm
EA assets/textures/west.xpm

F 194,160,128
C 217,179,119

        11111111111111      111111111111
        0000000000000                   
                            00000000000 
        0000000000000  N    00000000000 
        0000000000000       00000000000 
 000000000000000000000000    0000000000 
 00000000000000000000000000000000000000 
 00000000000000000000000000000000000000 
 000000000                              
 000000000000000000000000 
 000000000000000000000000 
 000000000000000000000000 
 000000000000                          
 0   00   00000 
111 1111 1111111
