NO assets/textures/north.xpm
SO assets/textures/south.xpm
WE assets/textures/east.xpm
EA assets/textures/west.xpm

F 194,160,128
C 217,179,119

111111111111111111111
1W0000000000000000001
111111111111111111111
